{
  "name": "The Grand Sealed Dungeon",
  "width": 30,
  "height": 30,
  "layers": [
    {
      "name": "terrain",
      "data": [
        [11,11,11,11,11,11,11,11,11,11,11,11,11,11,11, 11,11,11,11,11,11,11,11,11,11,11,11,11,11,11],
        [11, 0, 0, 0, 0, 0, 0, 0, 0, 0, 0, 0, 0, 0,11, 10,10,10,10,10,10,10,10,10,10,10,10,10,10,11],
        [11, 0, 0, 4, 4, 0, 0, 0, 0, 0, 0, 0, 0, 0,11, 10,10,10,10,10,10,10,10,10,10,10,10,10,10,11],
        [11,11, 0, 4, 0, 0, 0, 0, 0, 0, 0, 0, 0, 0,10, 10,10,10,10,10,10,10,10,10,10,10,10,10,10,11],
        [11,11, 0, 4, 4, 4, 4, 0, 0, 0, 0, 0, 0, 0,10, 10,10,10,10,10,10,10,10,10,10,10,10,10,10,11],
        [11, 0, 0, 0, 0, 0, 4, 0, 0, 0, 0, 0, 0,10,10, 10,10,10,10,10,10,10,10,10,10,10,10,10,10,11],
        [11, 0, 0, 2, 2, 2, 9, 2, 2, 2, 0, 0, 0,10,10, 10,10,10,10,10,10,10,10,10,10,10,10,10,10,11],
        [11, 0, 0, 2, 2, 2, 9, 2, 2, 2, 2, 0, 0,10,10, 10,10,10,10,10,10,10,10,10,10,10,10,10,10,11],
        [11,11, 0, 0, 0, 0, 4, 0, 0, 0, 2, 2, 0, 0,10, 10,10,10,10,10,10,10,10,10,10,10,10,10,10,11],
        [11,11,11, 0, 0, 0, 4, 4, 4, 0, 0, 2, 2, 0, 0, 10,10,10,10,10,10,10,10,10,10,10,10,10,10,11],
        [11,11,11, 0, 0, 0, 0, 0, 4, 4, 0, 0, 2, 0, 0, 10,10,10,10,10,10,10,10,10,10,10,10,10,10,11],
        [11, 0, 0, 0, 0, 0, 0, 0, 0, 4, 0, 0, 0, 0, 0, 10,10,10,10,10,10,10,10,10,10,10,10,10,10,11],
        [11, 0, 0, 0,11,11, 0, 0, 0, 4, 4, 4, 4, 4, 4,  4, 4, 4, 4, 4, 4, 4, 4,10,10,10,10,10,10,11],
        [11, 0, 0,11,11,11, 0, 0, 0, 0, 0, 0, 0, 0, 0,  0, 0, 0, 0, 0, 0, 0, 4,10,10,10,10,10,10,11],
        [11,11,11,11,11,11,11,11,11,11,11,11,11,11,11,  4,11,11,11,11,11,11,11,11,11,11,11,11,11,11],
        [ 1, 1, 1, 1, 1, 1, 1, 1, 1, 1, 1, 1, 1, 1, 1,  5, 1, 1, 1, 1, 1, 1, 1, 1, 1, 1, 1, 1, 1, 1],
        [ 1, 1, 1, 1, 1, 1, 1, 1, 1, 1, 1, 1, 5, 5, 5,  5, 5, 5, 5, 1, 1, 1, 1, 1, 1, 1, 1, 1, 1, 1],
        [ 1, 1, 9, 9, 9, 9, 9, 9, 9, 9, 9, 5, 5, 5, 5,  5, 5, 5, 5, 5, 8, 8, 8, 8, 8, 8, 8, 8, 8, 1],
        [ 1, 1, 9, 9, 9, 9, 9, 9, 9, 9, 9, 1, 5, 5, 5,  5, 5, 5, 5, 1, 8, 8, 8, 8, 8, 8, 8, 8, 8, 1],
        [ 1, 1, 9, 9, 9, 9, 9, 9, 9, 9, 9, 1, 5, 5, 5,  5, 5, 5, 5, 1, 8, 8, 2, 2, 2, 2, 2, 8, 8, 1],
        [ 1, 1, 9, 9, 9, 9, 9, 9, 9, 9, 9, 1, 5, 5, 5,  5, 5, 5, 5, 1, 8, 8, 2, 2, 2, 2, 2, 8, 8, 1],
        [ 1, 1, 1, 1, 1, 1, 1, 1, 1, 1, 1, 1, 1, 1, 1,  5, 1, 1, 1, 1, 1, 1, 1, 1, 1, 1, 1, 1, 1, 1],
        [ 1, 1, 1, 1, 1, 1, 1, 1, 1, 1, 1, 5, 5, 5, 5,  5, 5, 5, 5, 5, 1, 1, 1, 1, 1, 1, 1, 1, 1, 1],
        [ 1, 1, 1, 1, 1, 1, 1, 1, 1, 1, 1, 5, 5, 5, 5,  5, 5, 5, 5, 5, 1, 1, 1, 1, 1, 1, 1, 1, 1, 1],
        [ 1, 1, 1, 1, 1, 1, 1, 1, 1, 1, 1, 5, 5, 5, 5,  5, 5, 5, 5, 5, 1, 1, 1, 1, 1, 1, 1, 1, 1, 1],
        [ 1, 1, 1, 1, 1, 1, 1, 1, 1, 1, 1, 5, 5, 5, 5,  5, 5, 5, 5, 5, 1, 1, 1, 1, 1, 1, 1, 1, 1, 1],
        [ 1, 1, 1, 1, 1, 1, 1, 1, 1, 1, 1, 5, 5, 5, 5,  5, 5, 5, 5, 5, 1, 1, 1, 1, 1, 1, 1, 1, 1, 1],
        [ 1, 1, 1, 1, 1, 1, 1, 1, 1, 1, 1, 5, 5, 5, 5,  5, 5, 5, 5, 5, 1, 1, 1, 1, 1, 1, 1, 1, 1, 1],
        [ 1, 1, 1, 1, 1, 1, 1, 1, 1, 1, 1, 1, 1, 1, 1,  5, 1, 1, 1, 1, 1, 1, 1, 1, 1, 1, 1, 1, 1, 1],
        [ 1, 1, 1, 1, 1, 1, 1, 1, 1, 1, 1, 1, 1, 1, 1,  1, 1, 1, 1, 1, 1, 1, 1, 1, 1, 1, 1, 1, 1, 1]
      ]
    },
    {
      "name": "collision",
      "data": [
        [1, 1, 1, 1, 1, 1, 1, 1, 1, 1, 1, 1, 1, 1, 1,  1, 1, 1, 1, 1, 1, 1, 1, 1, 1, 1, 1, 1, 1, 1],
        [1, 0, 0, 0, 0, 0, 0, 0, 0, 0, 0, 0, 0, 0, 1,  0, 0, 0, 0, 0, 0, 0, 0, 0, 0, 0, 0, 0, 0, 1],
        [1, 0, 0, 0, 0, 0, 0, 0, 0, 0, 0, 0, 0, 0, 1,  0, 0, 0, 0, 0, 0, 0, 0, 0, 0, 0, 0, 0, 0, 1],
        [1, 1, 0, 0, 0, 0, 0, 0, 0, 0, 0, 0, 0, 0, 0,  0, 0, 0, 0, 0, 0, 0, 0, 0, 0, 0, 0, 0, 0, 1],
        [1, 1, 0, 0, 0, 0, 0, 0, 0, 0, 0, 0, 0, 0, 0,  0, 0, 0, 0, 0, 0, 0, 0, 0, 0, 0, 0, 0, 0, 1],
        [1, 0, 0, 0, 0, 0, 0, 0, 0, 0, 0, 0, 0, 0, 0,  0, 0, 0, 0, 0, 0, 0, 0, 0, 0, 0, 0, 0, 0, 1],
        [1, 0, 0, 1, 1, 1, 0, 1, 1, 1, 0, 0, 0, 0, 0,  0, 0, 0, 0, 0, 0, 0, 0, 0, 0, 0, 0, 0, 0, 1],
        [1, 0, 0, 1, 1, 1, 0, 1, 1, 1, 1, 0, 0, 0, 0,  0, 0, 0, 0, 0, 0, 0, 0, 0, 0, 0, 0, 0, 0, 1],
        [1, 1, 0, 0, 0, 0, 0, 0, 0, 0, 1, 1, 0, 0, 0,  0, 0, 0, 0, 0, 0, 0, 0, 0, 0, 0, 0, 0, 0, 1],
        [1, 1, 1, 0, 0, 0, 0, 0, 0, 0, 0, 1, 1, 0, 0,  0, 0, 0, 0, 0, 0, 0, 0, 0, 0, 0, 0, 0, 0, 1],
        [1, 1, 1, 0, 0, 0, 0, 0, 0, 0, 0, 0, 1, 0, 0,  0, 0, 0, 0, 0, 0, 0, 0, 0, 0, 0, 0, 0, 0, 1],
        [1, 0, 0, 0, 0, 0, 0, 0, 0, 0, 0, 0, 0, 0, 0,  0, 0, 0, 0, 0, 0, 0, 0, 0, 0, 0, 0, 0, 0, 1],
        [1, 0, 0, 0, 1, 1, 0, 0, 0, 0, 0, 0, 0, 0, 0,  0, 0, 0, 0, 0, 0, 0, 0, 0, 0, 0, 0, 0, 0, 1],
        [1, 0, 0, 1, 1, 1, 0, 0, 0, 0, 0, 0, 0, 0, 0,  0, 0, 0, 0, 0, 0, 0, 0, 0, 0, 0, 0, 0, 0, 1],
        [1, 1, 1, 1, 1, 1, 1, 1, 1, 1, 1, 1, 1, 1, 1,  0, 1, 1, 1, 1, 1, 1, 1, 1, 1, 1, 1, 1, 1, 1],
        [1, 1, 1, 1, 1, 1, 1, 1, 1, 1, 1, 1, 1, 1, 1,  1, 1, 1, 1, 1, 1, 1, 1, 1, 1, 1, 1, 1, 1, 1],
        [1, 1, 1, 1, 1, 1, 1, 1, 1, 1, 1, 1, 0, 0, 0,  0, 0, 0, 0, 1, 1, 1, 1, 1, 1, 1, 1, 1, 1, 1],
        [1, 1, 0, 0, 0, 0, 0, 0, 0, 0, 0, 1, 0, 0, 0,  0, 0, 0, 0, 1, 0, 0, 0, 0, 0, 0, 0, 0, 0, 1],
        [1, 1, 0, 0, 0, 0, 0, 0, 0, 0, 0, 1, 0, 0, 0,  0, 0, 0, 0, 1, 0, 0, 0, 0, 0, 0, 0, 0, 0, 1],
        [1, 1, 0, 0, 0, 0, 0, 0, 0, 0, 0, 1, 0, 0, 0,  0, 0, 0, 0, 1, 0, 0, 1, 1, 1, 1, 1, 0, 0, 1],
        [1, 1, 0, 0, 0, 0, 0, 0, 0, 0, 0, 1, 0, 0, 0,  0, 0, 0, 0, 1, 0, 0, 1, 1, 1, 1, 1, 0, 0, 1],
        [1, 1, 1, 1, 1, 1, 1, 1, 1, 1, 1, 1, 1, 1, 1,  1, 1, 1, 1, 1, 1, 1, 1, 1, 1, 1, 1, 1, 1, 1],
        [1, 1, 1, 1, 1, 1, 1, 1, 1, 1, 1, 0, 0, 0, 0,  0, 0, 0, 0, 0, 1, 1, 1, 1, 1, 1, 1, 1, 1, 1],
        [1, 1, 1, 1, 1, 1, 1, 1, 1, 1, 1, 0, 0, 0, 0,  0, 0, 0, 0, 0, 1, 1, 1, 1, 1, 1, 1, 1, 1, 1],
        [1, 1, 1, 1, 1, 1, 1, 1, 1, 1, 1, 0, 0, 0, 0,  0, 0, 0, 0, 0, 1, 1, 1, 1, 1, 1, 1, 1, 1, 1],
        [1, 1, 1, 1, 1, 1, 1, 1, 1, 1, 1, 0, 0, 0, 0,  0, 0, 0, 0, 0, 1, 1, 1, 1, 1, 1, 1, 1, 1, 1],
        [1, 1, 1, 1, 1, 1, 1, 1, 1, 1, 1, 0, 0, 0, 0,  0, 0, 0, 0, 0, 1, 1, 1, 1, 1, 1, 1, 1, 1, 1],
        [1, 1, 1, 1, 1, 1, 1, 1, 1, 1, 1, 0, 0, 0, 0,  0, 0, 0, 0, 0, 1, 1, 1, 1, 1, 1, 1, 1, 1, 1],
        [1, 1, 1, 1, 1, 1, 1, 1, 1, 1, 1, 1, 1, 1, 1,  1, 1, 1, 1, 1, 1, 1, 1, 1, 1, 1, 1, 1, 1, 1],
        [1, 1, 1, 1, 1, 1, 1, 1, 1, 1, 1, 1, 1, 1, 1,  1, 1, 1, 1, 1, 1, 1, 1, 1, 1, 1, 1, 1, 1, 1]
      ]
    }
  ],
  "objects": [
    {
      "type": "PLAYER_SPAWN",
      "x": 2,
      "y": 2
    },
    {
      "type": "ENEMY",
      "id": "forest_goblin",
      "x": 6,
      "y": 3,
      "sprite": "goblin",
      "health": 30,
      "attack": 5
    },
    {
      "type": "ITEM",
      "id": "health_potion",
      "name": "Health Potion",
      "item_type": "CONSUMABLE",
      "x": 1,
      "y": 6,
      "sprite": "potion"
    },
    {
      "type": "ITEM",
      "id": "dungeon_key",
      "name": "Main Dungeon Key",
      "item_type": "KEY_ITEM",
      "x": 25,
      "y": 5,
      "sprite": "key"
    },
    {
      "type": "DOOR",
      "id": "main_dungeon_gate",
      "x": 15,
      "y": 15,
      "sprite": "gate",
      "keyId": "dungeon_key",
      "isLevelExit": false
    },
    {
      "type": "ITEM",
      "id": "left_wing_key",
      "name": "Armory Key",
      "item_type": "KEY_ITEM",
      "x": 15,
      "y": 18,
      "sprite": "key"
    },
    {
      "type": "DOOR",
      "id": "left_door",
      "x": 11,
      "y": 17,
      "sprite": "gate",
      "keyId": "left_wing_key",
      "isLevelExit": false
    },
    {
      "type": "ENEMY",
      "id": "armory_goblin",
      "x": 5,
      "y": 18,
      "sprite": "goblin",
      "health": 50,
      "attack": 10
    },
    {
      "type": "CHEST",
      "id": "armory_chest",
      "x": 4,
      "y": 19,
      "sprite": "chest",
      "contents": [
        {
          "id": "right_wing_key",
          "name": "Grotto Key",
          "description": "Unlocks the flooded caves.",
          "sprite": "key",
          "type": "KEY_ITEM",
          "stackable": false,
          "quantity": 1
        },
        {
          "id": "iron_sword",
          "name": "Iron Sword",
          "description": "A sturdy blade.",
          "sprite": "sword",
          "type": "WEAPON",
          "stackable": false,
          "quantity": 1
        }
      ]
    },
    {
      "type": "DOOR",
      "id": "right_door",
      "x": 19,
      "y": 17,
      "sprite": "gate",
      "keyId": "right_wing_key",
      "isLevelExit": false
    },
    {
      "type": "ENEMY",
      "id": "water_goblin",
      "x": 25,
      "y": 18,
      "sprite": "goblin",
      "health": 50,
      "attack": 10
    },
    {
      "type": "ITEM",
      "id": "boss_key",
      "name": "Boss Room Key",
      "item_type": "KEY_ITEM",
      "x": 27,
      "y": 19,
      "sprite": "key"
    },
    {
      "type": "DOOR",
      "id": "boss_door",
      "x": 15,
      "y": 21,
      "sprite": "gate",
      "keyId": "boss_key",
      "isLevelExit": false
    },
    {
      "type": "ENEMY",
      "id": "boss_goblin",
      "x": 15,
      "y": 24,
      "sprite": "goblin",
      "health": 200,
      "attack": 20
    },
    {
      "type": "CHEST",
      "id": "epic_chest",
      "x": 15,
      "y": 26,
      "sprite": "chest",
      "contents": [
        {
          "id": "super_potion",
          "name": "Super Health Potion",
          "description": "Restores a lot of health.",
          "sprite": "potion",
          "type": "CONSUMABLE",
          "stackable": true,
          "quantity": 3
        },
        {
          "id": "legendary_sword",
          "name": "Legendary Sword",
          "description": "A glowing magical blade.",
          "sprite": "sword",
          "type": "WEAPON",
          "stackable": false,
          "quantity": 1
        }
      ]
    },
    {
      "type": "DOOR",
      "id": "level_exit",
      "x": 15,
      "y": 28,
      "sprite": "gate",
      "isLevelExit": true
    },




    {
      "type": "LIGHT_SOURCE",
      "id": "torch5",
      "x": 5,
      "y": 17,
      "sprite": "torch",
      "radius": 0
    },
    {
      "type": "LIGHT_SOURCE",
      "id": "torch6",
      "x": 5,
      "y": 20,
      "sprite": "torch",
      "radius": 1
    },
    {
      "type": "LIGHT_SOURCE",
      "id": "torch7",
      "x": 25,
      "y": 17,
      "sprite": "torch",
      "radius": 0
    },
    {
      "type": "LIGHT_SOURCE",
      "id": "torch8",
      "x": 25,
      "y": 20,
      "sprite": "torch",
      "radius": 1
    },
    {
      "type": "LIGHT_SOURCE",
      "id": "torch9",
      "x": 12,
      "y": 23,
      "sprite": "torch",
      "radius": 0
    },
    {
      "type": "LIGHT_SOURCE",
      "id": "torch10",
      "x": 18,
      "y": 23,
      "sprite": "torch",
      "radius": 1
    }


  ]
}