{
  "name": "Level 2: The Frozen Stronghold",
  "width": 30,
  "height": 30,
  "layers": [
    {
      "name": "terrain",
      "data": [
        [7, 7, 7, 7, 7, 7, 7, 7, 7, 7, 7, 7, 7, 7, 7, 7, 7, 7, 7, 7, 7, 7, 7, 7, 7, 7, 7, 7, 7, 7],
        [7, 11, 11, 7, 7, 7, 7, 7, 7, 7, 7, 7, 7, 7, 7, 7, 7, 7, 7, 7, 7, 7, 7, 7, 7, 7, 7, 7, 7, 7],
        [7, 11, 7, 7, 7, 7, 7, 7, 7, 7, 7, 7, 7, 7, 7, 7, 7, 7, 7, 7, 7, 7, 7, 7, 7, 7, 7, 7, 7, 7],
        [7, 7, 7, 7, 7, 7, 7, 7, 7, 7, 7, 7, 7, 7, 7, 7, 7, 7, 7, 7, 7, 7, 7, 7, 7, 7, 7, 7, 7, 7],
        [7, 7, 7, 7, 7, 7, 7, 7, 7, 7, 7, 7, 7, 7, 7, 7, 7, 7, 7, 7, 7, 7, 7, 7, 7, 7, 7, 7, 7, 7],
        [7, 7, 7, 7, 7, 6, 6, 6, 6, 6, 9, 9, 6, 6, 6, 6, 6, 6, 6, 6, 6, 6, 6, 6, 6, 7, 7, 7, 7, 7],
        [7, 7, 7, 7, 7, 6, 6, 6, 6, 6, 9, 9, 6, 6, 6, 6, 6, 6, 6, 6, 6, 6, 6, 6, 6, 7, 7, 7, 7, 7],
        [7, 7, 7, 7, 7, 6, 6, 6, 6, 6, 9, 9, 6, 6, 6, 6, 6, 6, 6, 6, 6, 6, 6, 6, 6, 7, 7, 7, 7, 7],
        [7, 7, 7, 7, 7, 9, 9, 9, 9, 9, 9, 9, 9, 9, 9, 9, 9, 9, 9, 9, 9, 9, 9, 9, 9, 7, 7, 7, 7, 7],
        [7, 7, 7, 7, 7, 9, 9, 9, 9, 9, 9, 9, 9, 9, 9, 9, 9, 9, 9, 9, 9, 9, 9, 9, 9, 7, 7, 7, 7, 7],
        [7, 7, 7, 7, 7, 6, 6, 6, 6, 6, 9, 9, 6, 6, 6, 6, 6, 6, 6, 6, 6, 6, 6, 6, 6, 7, 7, 7, 7, 7],
        [7, 7, 7, 7, 7, 6, 6, 6, 6, 6, 9, 9, 6, 6, 6, 6, 6, 6, 6, 6, 6, 6, 6, 6, 6, 7, 7, 7, 7, 7],
        [7, 7, 7, 7, 7, 6, 6, 6, 6, 6, 9, 9, 6, 6, 6, 6, 6, 6, 6, 6, 6, 6, 6, 6, 6, 7, 7, 7, 7, 7],
        [7, 7, 7, 7, 7, 6, 6, 6, 6, 6, 9, 9, 6, 6, 6, 6, 6, 6, 6, 6, 6, 6, 6, 6, 6, 7, 7, 7, 7, 7],
        [7, 7, 7, 7, 7, 6, 6, 6, 6, 6, 9, 9, 6, 6, 6, 6, 6, 6, 6, 6, 6, 6, 6, 6, 6, 7, 7, 7, 7, 7],
        [7, 7, 7, 7, 7, 7, 7, 7, 7, 7, 7, 7, 7, 7, 7, 7, 7, 7, 7, 7, 7, 7, 7, 7, 7, 7, 7, 7, 7, 7],
        [7, 7, 7, 7, 7, 7, 7, 7, 7, 7, 7, 7, 7, 7, 7, 7, 7, 7, 7, 7, 7, 7, 7, 7, 7, 7, 7, 7, 7, 7],
        [7, 7, 7, 7, 7, 1, 1, 1, 1, 1, 1, 1, 1, 1, 5, 5, 1, 1, 1, 1, 1, 1, 1, 1, 1, 7, 7, 7, 7, 7],
        [7, 7, 7, 7, 7, 1, 5, 5, 5, 5, 5, 1, 5, 5, 5, 5, 5, 5, 1, 5, 5, 5, 5, 5, 1, 7, 7, 7, 7, 7],
        [7, 7, 7, 7, 7, 1, 5, 5, 5, 5, 5, 1, 5, 5, 5, 5, 5, 5, 1, 5, 5, 5, 5, 5, 1, 7, 7, 7, 7, 7],
        [7, 7, 7, 7, 7, 1, 5, 5, 5, 5, 5, 1, 5, 5, 5, 5, 5, 5, 1, 5, 5, 5, 5, 5, 1, 7, 7, 7, 7, 7],
        [7, 7, 7, 7, 7, 1, 5, 5, 5, 5, 5, 1, 5, 5, 5, 5, 5, 5, 1, 5, 5, 5, 5, 5, 1, 7, 7, 7, 7, 7],
        [7, 7, 7, 7, 7, 1, 5, 5, 5, 5, 5, 1, 5, 5, 5, 5, 5, 5, 1, 5, 5, 5, 5, 5, 1, 7, 7, 7, 7, 7],
        [7, 7, 7, 7, 7, 1, 5, 5, 5, 5, 5, 1, 1, 1, 1, 1, 1, 1, 1, 5, 5, 5, 5, 5, 1, 7, 7, 7, 7, 7],
        [7, 7, 7, 7, 7, 1, 5, 5, 5, 5, 5, 1, 5, 5, 5, 5, 5, 5, 1, 5, 5, 5, 5, 5, 1, 7, 7, 7, 7, 7],
        [7, 7, 7, 7, 7, 1, 5, 5, 5, 5, 5, 1, 5, 5, 5, 5, 5, 5, 1, 5, 5, 5, 5, 5, 1, 7, 7, 7, 7, 7],
        [7, 7, 7, 7, 7, 1, 5, 5, 5, 5, 5, 1, 5, 5, 5, 5, 5, 5, 1, 5, 5, 5, 5, 5, 1, 7, 7, 7, 7, 7],
        [7, 7, 7, 7, 7, 1, 5, 5, 5, 5, 5, 1, 5, 5, 5, 5, 5, 5, 1, 5, 5, 5, 5, 5, 1, 7, 7, 7, 11, 7],
        [7, 7, 7, 7, 7, 1, 1, 1, 1, 1, 1, 1, 1, 1, 1, 1, 1, 1, 1, 1, 1, 1, 1, 1, 1, 7, 7, 11, 11, 7],
        [7, 7, 7, 7, 7, 7, 7, 7, 7, 7, 7, 7, 7, 7, 7, 7, 7, 7, 7, 7, 7, 7, 7, 7, 7, 7, 7, 7, 7, 7]
      ]
    },
    {
      "name": "collision",
      "data": [
        [0, 0, 0, 0, 0, 0, 0, 0, 0, 0, 0, 0, 0, 0, 0, 0, 0, 0, 0, 0, 0, 0, 0, 0, 0, 0, 0, 0, 0, 0],
        [0, 1, 1, 0, 0, 0, 0, 0, 0, 0, 0, 0, 0, 0, 0, 0, 0, 0, 0, 0, 0, 0, 0, 0, 0, 0, 0, 0, 0, 0],
        [0, 1, 0, 0, 0, 0, 0, 0, 0, 0, 0, 0, 0, 0, 0, 0, 0, 0, 0, 0, 0, 0, 0, 0, 0, 0, 0, 0, 0, 0],
        [0, 0, 0, 0, 0, 0, 0, 0, 0, 0, 0, 0, 0, 0, 0, 0, 0, 0, 0, 0, 0, 0, 0, 0, 0, 0, 0, 0, 0, 0],
        [0, 0, 0, 0, 0, 0, 0, 0, 0, 0, 0, 0, 0, 0, 0, 0, 0, 0, 0, 0, 0, 0, 0, 0, 0, 0, 0, 0, 0, 0],
        [0, 0, 0, 0, 0, 1, 1, 1, 1, 1, 0, 0, 1, 1, 1, 1, 1, 1, 1, 1, 1, 1, 1, 1, 1, 0, 0, 0, 0, 0],
        [0, 0, 0, 0, 0, 1, 1, 1, 1, 1, 0, 0, 1, 1, 1, 1, 1, 1, 1, 1, 1, 1, 1, 1, 1, 0, 0, 0, 0, 0],
        [0, 0, 0, 0, 0, 1, 1, 1, 1, 1, 0, 0, 1, 1, 1, 1, 1, 1, 1, 1, 1, 1, 1, 1, 1, 0, 0, 0, 0, 0],
        [0, 0, 0, 0, 0, 0, 0, 0, 0, 0, 0, 0, 0, 0, 0, 0, 0, 0, 0, 0, 0, 0, 0, 0, 0, 0, 0, 0, 0, 0],
        [0, 0, 0, 0, 0, 0, 0, 0, 0, 0, 0, 0, 0, 0, 0, 0, 0, 0, 0, 0, 0, 0, 0, 0, 0, 0, 0, 0, 0, 0],
        [0, 0, 0, 0, 0, 1, 1, 1, 1, 1, 0, 0, 1, 1, 1, 1, 1, 1, 1, 1, 1, 1, 1, 1, 1, 0, 0, 0, 0, 0],
        [0, 0, 0, 0, 0, 1, 1, 1, 1, 1, 0, 0, 1, 1, 1, 1, 1, 1, 1, 1, 1, 1, 1, 1, 1, 0, 0, 0, 0, 0],
        [0, 0, 0, 0, 0, 1, 1, 1, 1, 1, 0, 0, 1, 1, 1, 1, 1, 1, 1, 1, 1, 1, 1, 1, 1, 0, 0, 0, 0, 0],
        [0, 0, 0, 0, 0, 1, 1, 1, 1, 1, 0, 0, 1, 1, 1, 1, 1, 1, 1, 1, 1, 1, 1, 1, 1, 0, 0, 0, 0, 0],
        [0, 0, 0, 0, 0, 1, 1, 1, 1, 1, 0, 0, 1, 1, 1, 1, 1, 1, 1, 1, 1, 1, 1, 1, 1, 0, 0, 0, 0, 0],
        [0, 0, 0, 0, 0, 0, 0, 0, 0, 0, 0, 0, 0, 0, 0, 0, 0, 0, 0, 0, 0, 0, 0, 0, 0, 0, 0, 0, 0, 0],
        [0, 0, 0, 0, 0, 0, 0, 0, 0, 0, 0, 0, 0, 0, 0, 0, 0, 0, 0, 0, 0, 0, 0, 0, 0, 0, 0, 0, 0, 0],
        [0, 0, 0, 0, 0, 1, 1, 1, 1, 1, 1, 1, 1, 1, 1, 1, 1, 1, 1, 1, 1, 1, 1, 1, 1, 0, 0, 0, 0, 0],
        [0, 0, 0, 0, 0, 1, 0, 0, 0, 0, 0, 1, 0, 0, 0, 0, 0, 0, 1, 0, 0, 0, 0, 0, 1, 0, 0, 0, 0, 0],
        [0, 0, 0, 0, 0, 1, 0, 0, 0, 0, 0, 1, 0, 0, 0, 0, 0, 0, 1, 0, 0, 0, 0, 0, 1, 0, 0, 0, 0, 0],
        [0, 0, 0, 0, 0, 1, 0, 0, 0, 0, 0, 1, 0, 0, 0, 0, 0, 0, 1, 0, 0, 0, 0, 0, 1, 0, 0, 0, 0, 0],
        [0, 0, 0, 0, 0, 1, 0, 0, 0, 0, 0, 1, 0, 0, 0, 0, 0, 0, 1, 0, 0, 0, 0, 0, 1, 0, 0, 0, 0, 0],
        [0, 0, 0, 0, 0, 1, 0, 0, 0, 0, 0, 1, 0, 0, 0, 0, 0, 0, 1, 0, 0, 0, 0, 0, 1, 0, 0, 0, 0, 0],
        [0, 0, 0, 0, 0, 1, 0, 0, 0, 0, 0, 1, 1, 1, 1, 1, 1, 1, 1, 0, 0, 0, 0, 0, 1, 0, 0, 0, 0, 0],
        [0, 0, 0, 0, 0, 1, 0, 0, 0, 0, 0, 1, 0, 0, 0, 0, 0, 0, 1, 0, 0, 0, 0, 0, 1, 0, 0, 0, 0, 0],
        [0, 0, 0, 0, 0, 1, 0, 0, 0, 0, 0, 1, 0, 0, 0, 0, 0, 0, 1, 0, 0, 0, 0, 0, 1, 0, 0, 0, 0, 0],
        [0, 0, 0, 0, 0, 1, 0, 0, 0, 0, 0, 1, 0, 0, 0, 0, 0, 0, 1, 0, 0, 0, 0, 0, 1, 0, 0, 0, 0, 0],
        [0, 0, 0, 0, 0, 1, 0, 0, 0, 0, 0, 1, 0, 0, 0, 0, 0, 0, 1, 0, 0, 0, 0, 0, 1, 0, 0, 0, 1, 0],
        [0, 0, 0, 0, 0, 1, 1, 1, 1, 1, 1, 1, 1, 1, 1, 1, 1, 1, 1, 1, 1, 1, 1, 1, 1, 0, 0, 1, 1, 0],
        [0, 0, 0, 0, 0, 0, 0, 0, 0, 0, 0, 0, 0, 0, 0, 0, 0, 0, 0, 0, 0, 0, 0, 0, 0, 0, 0, 0, 0, 0]
      ]
    }
  ],
  "objects": [
    {
      "type": "PLAYER_SPAWN",
      "x": 2,
      "y": 2
    },
    {
      "type": "ITEM",
      "id": "stronghold_key",
      "name": "Stronghold Key",
      "item_type": "KEY_ITEM",
      "x": 22,
      "y": 12,
      "sprite": "key"
    },
    {
      "type": "ENEMY",
      "id": "bridge_guard",
      "x": 10,
      "y": 8,
      "sprite": "goblin",
      "health": 80,
      "attack": 12
    },
    {
      "type": "DOOR",
      "id": "main_gate",
      "x": 14,
      "y": 17,
      "sprite": "gate",
      "keyId": "stronghold_key",
      "isLevelExit": false
    },
    {
      "type": "ITEM",
      "id": "left_wing_key",
      "name": "Armory Key",
      "item_type": "KEY_ITEM",
      "x": 14,
      "y": 19,
      "sprite": "key"
    },
    {
      "type": "DOOR",
      "id": "left_door",
      "x": 11,
      "y": 20,
      "sprite": "gate",
      "keyId": "left_wing_key",
      "isLevelExit": false
    },
    {
      "type": "CHEST",
      "id": "armory_chest",
      "x": 8,
      "y": 20,
      "sprite": "chest",
      "contents": [
        {
          "id": "right_wing_key",
          "name": "Grotto Key",
          "description": "Unlocks the right wing.",
          "sprite": "key",
          "type": "KEY_ITEM",
          "stackable": false,
          "quantity": 1
        },
        {
          "id": "steel_sword",
          "name": "Steel Sword",
          "description": "A sharp steel blade.",
          "sprite": "sword",
          "type": "WEAPON",
          "stackable": false,
          "quantity": 1
        }
      ]
    },
    {
      "type": "DOOR",
      "id": "right_door",
      "x": 18,
      "y": 20,
      "sprite": "gate",
      "keyId": "right_wing_key",
      "isLevelExit": false
    },
    {
      "type": "ENEMY",
      "id": "right_wing_guard",
      "x": 21,
      "y": 20,
      "sprite": "goblin",
      "health": 100,
      "attack": 15
    },
    {
      "type": "ITEM",
      "id": "boss_key",
      "name": "Boss Key",
      "item_type": "KEY_ITEM",
      "x": 23,
      "y": 25,
      "sprite": "key"
    },
    {
      "type": "DOOR",
      "id": "boss_door",
      "x": 14,
      "y": 23,
      "sprite": "gate",
      "keyId": "boss_key",
      "isLevelExit": false
    },
    {
      "type": "ENEMY",
      "id": "ice_boss",
      "x": 14,
      "y": 26,
      "sprite": "goblin",
      "health": 300,
      "attack": 25
    },
    {
      "type": "CHEST",
      "id": "boss_chest",
      "x": 12,
      "y": 26,
      "sprite": "chest",
      "contents": [
        {
          "id": "mega_potion",
          "name": "Mega Potion",
          "description": "Restores max health.",
          "sprite": "potion",
          "type": "CONSUMABLE",
          "stackable": true,
          "quantity": 5
        }
      ]
    },
    {
      "type": "DOOR",
      "id": "level_2_exit",
      "x": 14,
      "y": 27,
      "sprite": "gate",
      "isLevelExit": true
    },
    {
      "type": "LIGHT_SOURCE",
      "id": "torch_1",
      "x": 13,
      "y": 18,
      "sprite": "torch",
      "radius": 5
    },
    {
      "type": "LIGHT_SOURCE",
      "id": "torch_2",
      "x": 16,
      "y": 18,
      "sprite": "torch",
      "radius": 5
    },
    {
      "type": "LIGHT_SOURCE",
      "id": "torch_3",
      "x": 12,
      "y": 24,
      "sprite": "torch",
      "radius": 7
    },
    {
      "type": "LIGHT_SOURCE",
      "id": "torch_4",
      "x": 17,
      "y": 24,
      "sprite": "torch",
      "radius": 7
    }
  ]
}