{
  "name": "New Test Map",
  "width": 10,
  "height": 10,
  "layers": [
    {
      "name": "terrain",
      "data": [
        [1, 1, 1, 1, 1, 1, 1, 1, 1, 1],
        [1, 0, 0, 0, 0, 0, 0, 0, 0, 1],
        [1, 0, 0, 0, 0, 0, 0, 0, 0, 1],
        [1, 0, 0, 0, 0, 0, 0, 0, 0, 1],
        [1, 0, 0, 0, 1, 1, 0, 0, 0, 1],
        [1, 0, 0, 0, 1, 1, 0, 0, 0, 1],
        [1, 0, 0, 0, 0, 0, 0, 0, 0, 1],
        [1, 0, 0, 0, 0, 0, 0, 0, 0, 1],
        [1, 0, 0, 0, 0, 0, 0, 0, 0, 1],
        [1, 1, 1, 1, 1, 1, 1, 1, 1, 1]
      ]
    },
    {
      "name": "collision",
      "data": [
        [1, 1, 1, 1, 1, 1, 1, 1, 1, 1],
        [1, 0, 0, 0, 0, 0, 0, 0, 0, 1],
        [1, 0, 0, 0, 0, 0, 0, 0, 0, 1],
        [1, 0, 0, 0, 0, 0, 0, 0, 0, 1],
        [1, 0, 0, 0, 1, 1, 0, 0, 0, 1],
        [1, 0, 0, 0, 1, 1, 0, 0, 0, 1],
        [1, 0, 0, 0, 0, 0, 0, 0, 0, 1],
        [1, 0, 0, 0, 0, 0, 0, 0, 0, 1],
        [1, 0, 0, 0, 0, 0, 0, 0, 0, 1],
        [1, 1, 1, 1, 1, 1, 1, 1, 1, 1]
      ]
    }
  ],
  "objects": [
    {
      "type": "PLAYER_SPAWN",
      "x": 1,
      "y": 1
    }
  ]
}